8 16

################
S--/----/---####
#####-#####/--##
###---#---E##-##
###-###-#-###-##
###/#-/---###/##
###-####-####-##
###--/---####-##

1 0

