13 24
########################
s--------|--############
###-######-#############
###-|---|--------#######
######R#########-#######
###---------####r--#####
###-###-###------|--####
####-###-######+####-#-e
###-###--|--------/--/-#
###-########-####-######
###----------####-######
#################---####
####################e###

1 0
