13 24
XXXXXXXXXXXXXXXXXXXXXXXX
*--------R--###########X
X###-######-###########X
X###-R---R--------#####X
X######R#########-#####X
X###---------####R--###X
X###-###-###------#--##X
X###-###-######+####-#-@
X###-###--R--------R--RX
X###-########-####-####X
X###----------####-####X
X#################---##X
XXXXXXXXXXXXXXXXXXXX@XXX


H 0 1 *
