13 24
########################
S--------|--############
###-######-#############
###-|---|--------#######
######R#########-#######
###---------####R--#####
###-###-###------|--####
####-###-######+####-#-E
###-###--|--------/--/-#
###-########-####-######
###----------####-######
#################---####
####################E###

1 0
