13 24
XXXXXXXXXXXXXXXXXXXXXXXX
*--------\--###########X
X###-######-###########X
X###-\---\--------#####X
X######\#########-#####X
X###---------####\--###X
X###-###-###------#--##X
X###-###-######+####-#-@
X###-###--\--------/--/X
X###-########-####-####X
X###----------####-####X
X#################---##X
XXXXXXXXXXXXXXXXXXXX@XXX


H 0 1 *
