13 24

###############S########
#-----/-----/---------##
#/#########-########-###
#-#########-###---##/###
#-#########-########-###
#-#########/--------/###
#/---/------#-######-###
#-###########-##--##---#
#-###------##-##--##-###
#-##---E##-##-######/###
#-########-##-######-###
#/-----/-----/--/----###
########################

1 0

