7 14

##############
S--/----######
###-###--#####
###-####/#####
###-####-#####
###---/----/##
###########E##
1 0