6 10

#S########
#---/---##
#/#####-##
#----/#/##
#--/----##
######E###

0 1