13 24

########################
S--------/--############
###-######-#############
###-|---|--------#######
######-#########-#######
###---------####---#####
###-###-###------|---###
###-###-#######-####-#-E
###-###--|--------/--/-#
###-########-####-######
###----------####-######
#################----###
####################E###

1 0

